1111111111111111111111111111111
1500000220200302040200202020001
1010101210101212101010121212101
1002200000222002003000204020201
1010101010121010121210101010121
1200000000020220020020003000001
1010101010101010101210121010101
1200200000020020000002000000001
1010101012101010121210101010101
1200002200200000002000000000001
1012101010101010121010101010101
1000000000002000200200000000001
1111111111111111111111111111111